2 2 2 2 2 2 2 2 2 2 2 2 2 2 2 2 2 2 2 2 2 2 2
2 2 2 2 2 2 2 2 2 2 2 2 2 2 2 2 2 2 2 2 2 2 2
2 2 2 2 2 2 2 2 2 2 2 2 2 2 2 2 2 2 2 2 2 2 2
2 2 2 2 2 2 2 2 2 2 2 2 2 2 2 2 2 2 2 2 2 2 2
2 2 2 2 2 2 2 2 2 2 2 2 2 2 2 2 2 2 2 2 2 2 2
2 2 2 2 2 2 2 2 2 2 2 1 2 2 2 2 2 2 2 2 2 2 2
2 2 2 2 2 2 1 1 1 1 1 1 1 1 1 1 1 2 2 2 2 2 2
2 2 2 2 2 2 1 3 3 3 3 3 3 3 3 3 1 2 2 2 2 2 2
2 2 2 2 2 2 1 3 0 0 0 0 0 0 0 3 1 2 2 2 2 2 2
2 2 2 2 2 2 1 3 0 0 0 0 0 0 0 3 1 2 2 2 2 2 2
2 2 2 2 2 2 1 3 0 0 0 0 0 0 0 3 1 2 2 2 2 2 2
2 2 2 2 2 2 1 3 0 0 0 0 0 0 0 3 1 2 2 2 2 2 2
2 2 2 2 2 2 1 3 0 0 0 0 0 0 0 3 1 2 2 2 2 2 2
2 2 2 2 2 2 1 3 3 3 3 0 3 3 3 3 1 2 2 2 2 2 2
2 2 2 2 2 2 1 1 2 2 1 1 1 2 2 1 1 2 2 2 2 2 2
2 2 2 2 2 2 1 1 1 1 1 1 1 1 1 1 1 2 2 2 2 2 2
4 4 4 4 4 4 4 4 4 4 5 5 5 4 4 4 4 4 4 4 4 4 4
4 4 4 4 4 4 4 4 4 4 5 5 5 4 4 4 4 4 4 4 4 4 4
4 4 4 4 4 4 4 4 4 4 5 5 5 4 4 4 4 4 4 4 4 4 4
4 4 4 4 4 4 4 4 4 4 4 4 4 4 4 4 4 4 4 4 4 4 4
4 4 4 4 4 4 4 4 4 4 4 4 4 4 4 4 4 4 4 4 4 4 4
4 4 4 4 4 4 4 4 4 4 4 4 4 4 4 4 4 4 4 4 4 4 4
4 4 4 4 4 4 4 4 4 4 4 4 4 4 4 4 4 4 4 4 4 4 4
4 4 4 4 4 4 4 4 4 4 4 4 4 4 4 4 4 4 4 4 4 4 4